"filename", "language", "C++", "Properties", "Makefile", "HTML", "comment", "blank", "total"
"/nfs/homes/kkonarze/Portfolio/Core/Project05/webserv/Makefile", "Makefile", 0, 0, 35, 0, 3, 13, 51
"/nfs/homes/kkonarze/Portfolio/Core/Project05/webserv/default.conf", "Properties", 0, 29, 0, 0, 7, 7, 43
"/nfs/homes/kkonarze/Portfolio/Core/Project05/webserv/include/Client.hpp", "C++", 24, 0, 0, 0, 11, 7, 42
"/nfs/homes/kkonarze/Portfolio/Core/Project05/webserv/include/Config.hpp", "C++", 16, 0, 0, 0, 11, 4, 31
"/nfs/homes/kkonarze/Portfolio/Core/Project05/webserv/include/ConfigParser.hpp", "C++", 35, 0, 0, 0, 11, 9, 55
"/nfs/homes/kkonarze/Portfolio/Core/Project05/webserv/include/Location.hpp", "C++", 29, 0, 0, 0, 11, 9, 49
"/nfs/homes/kkonarze/Portfolio/Core/Project05/webserv/include/Request.hpp", "C++", 28, 0, 0, 0, 0, 5, 33
"/nfs/homes/kkonarze/Portfolio/Core/Project05/webserv/include/Server.hpp", "C++", 39, 0, 0, 0, 11, 11, 61
"/nfs/homes/kkonarze/Portfolio/Core/Project05/webserv/include/Signal.hpp", "C++", 13, 0, 0, 0, 11, 8, 32
"/nfs/homes/kkonarze/Portfolio/Core/Project05/webserv/include/Webserv.hpp", "C++", 14, 0, 0, 0, 12, 6, 32
"/nfs/homes/kkonarze/Portfolio/Core/Project05/webserv/src/ConfigTokens.cpp", "C++", 125, 0, 0, 0, 12, 33, 170
"/nfs/homes/kkonarze/Portfolio/Core/Project05/webserv/src/Definitions/Client.cpp", "C++", 76, 0, 0, 0, 11, 13, 100
"/nfs/homes/kkonarze/Portfolio/Core/Project05/webserv/src/Definitions/ConfigParser.cpp", "C++", 107, 0, 0, 0, 37, 19, 163
"/nfs/homes/kkonarze/Portfolio/Core/Project05/webserv/src/Definitions/Location.cpp", "C++", 49, 0, 0, 0, 30, 11, 90
"/nfs/homes/kkonarze/Portfolio/Core/Project05/webserv/src/Definitions/Request.cpp", "C++", 88, 0, 0, 0, 11, 17, 116
"/nfs/homes/kkonarze/Portfolio/Core/Project05/webserv/src/Definitions/Server.cpp", "C++", 148, 0, 0, 0, 11, 30, 189
"/nfs/homes/kkonarze/Portfolio/Core/Project05/webserv/src/Definitions/Signal.cpp", "C++", 17, 0, 0, 0, 11, 7, 35
"/nfs/homes/kkonarze/Portfolio/Core/Project05/webserv/src/LocationTokens.cpp", "C++", 66, 0, 0, 0, 11, 26, 103
"/nfs/homes/kkonarze/Portfolio/Core/Project05/webserv/src/Utils.cpp", "C++", 75, 0, 0, 0, 56, 11, 142
"/nfs/homes/kkonarze/Portfolio/Core/Project05/webserv/src/main.cpp", "C++", 35, 0, 0, 0, 11, 9, 55
"/nfs/homes/kkonarze/Portfolio/Core/Project05/webserv/www/index.html", "HTML", 0, 0, 0, 58, 0, 6, 64
"/nfs/homes/kkonarze/Portfolio/Core/Project05/webserv/www/thankyou.html", "HTML", 0, 0, 0, 28, 0, 3, 31
"Total", "-", 984, 29, 35, 86, 289, 264, 1687