"filename", "language", "C++", "HTML", "Makefile", "Properties", "PostCSS", "comment", "blank", "total"
"/nfs/homes/kkonarze/Portfolio/Core/Project05/webserv/Makefile", "Makefile", 0, 0, 36, 0, 0, 3, 13, 52
"/nfs/homes/kkonarze/Portfolio/Core/Project05/webserv/default.conf", "Properties", 0, 0, 0, 29, 0, 7, 7, 43
"/nfs/homes/kkonarze/Portfolio/Core/Project05/webserv/errors/404.html", "HTML", 0, 38, 0, 0, 0, 0, 0, 38
"/nfs/homes/kkonarze/Portfolio/Core/Project05/webserv/include/Client.hpp", "C++", 24, 0, 0, 0, 0, 11, 7, 42
"/nfs/homes/kkonarze/Portfolio/Core/Project05/webserv/include/Config.hpp", "C++", 19, 0, 0, 0, 0, 11, 5, 35
"/nfs/homes/kkonarze/Portfolio/Core/Project05/webserv/include/ConfigParser.hpp", "C++", 36, 0, 0, 0, 0, 11, 9, 56
"/nfs/homes/kkonarze/Portfolio/Core/Project05/webserv/include/Location.hpp", "C++", 29, 0, 0, 0, 0, 11, 9, 49
"/nfs/homes/kkonarze/Portfolio/Core/Project05/webserv/include/Request.hpp", "C++", 29, 0, 0, 0, 0, 0, 5, 34
"/nfs/homes/kkonarze/Portfolio/Core/Project05/webserv/include/Response.hpp", "C++", 32, 0, 0, 0, 0, 11, 8, 51
"/nfs/homes/kkonarze/Portfolio/Core/Project05/webserv/include/Server.hpp", "C++", 37, 0, 0, 0, 0, 11, 11, 59
"/nfs/homes/kkonarze/Portfolio/Core/Project05/webserv/include/Signal.hpp", "C++", 13, 0, 0, 0, 0, 11, 8, 32
"/nfs/homes/kkonarze/Portfolio/Core/Project05/webserv/include/Webserv.hpp", "C++", 15, 0, 0, 0, 0, 12, 6, 33
"/nfs/homes/kkonarze/Portfolio/Core/Project05/webserv/src/ConfigTokens.cpp", "C++", 94, 0, 0, 0, 0, 11, 27, 132
"/nfs/homes/kkonarze/Portfolio/Core/Project05/webserv/src/Definitions/Client.cpp", "C++", 76, 0, 0, 0, 0, 11, 13, 100
"/nfs/homes/kkonarze/Portfolio/Core/Project05/webserv/src/Definitions/ConfigParser.cpp", "C++", 117, 0, 0, 0, 0, 37, 22, 176
"/nfs/homes/kkonarze/Portfolio/Core/Project05/webserv/src/Definitions/Location.cpp", "C++", 49, 0, 0, 0, 0, 30, 11, 90
"/nfs/homes/kkonarze/Portfolio/Core/Project05/webserv/src/Definitions/Request.cpp", "C++", 88, 0, 0, 0, 0, 11, 17, 116
"/nfs/homes/kkonarze/Portfolio/Core/Project05/webserv/src/Definitions/Response.cpp", "C++", 104, 0, 0, 0, 0, 11, 22, 137
"/nfs/homes/kkonarze/Portfolio/Core/Project05/webserv/src/Definitions/Server.cpp", "C++", 111, 0, 0, 0, 0, 11, 20, 142
"/nfs/homes/kkonarze/Portfolio/Core/Project05/webserv/src/Definitions/Signal.cpp", "C++", 17, 0, 0, 0, 0, 11, 7, 35
"/nfs/homes/kkonarze/Portfolio/Core/Project05/webserv/src/LocationTokens.cpp", "C++", 66, 0, 0, 0, 0, 11, 26, 103
"/nfs/homes/kkonarze/Portfolio/Core/Project05/webserv/src/Utils.cpp", "C++", 82, 0, 0, 0, 0, 62, 13, 157
"/nfs/homes/kkonarze/Portfolio/Core/Project05/webserv/src/main.cpp", "C++", 34, 0, 0, 0, 0, 11, 9, 54
"/nfs/homes/kkonarze/Portfolio/Core/Project05/webserv/www/index.html", "HTML", 0, 21, 0, 0, 0, 0, 6, 27
"/nfs/homes/kkonarze/Portfolio/Core/Project05/webserv/www/style.css", "PostCSS", 0, 0, 0, 0, 36, 0, 0, 36
"/nfs/homes/kkonarze/Portfolio/Core/Project05/webserv/www/thankyou.html", "HTML", 0, 28, 0, 0, 0, 0, 3, 31
"Total", "-", 1072, 87, 36, 29, 36, 316, 284, 1860