"filename", "language", "C++", "Makefile", "PostCSS", "HTML", "Properties", "comment", "blank", "total"
"/nfs/homes/kkonarze/Portfolio/Core/Project05/webserv/Makefile", "Makefile", 0, 36, 0, 0, 0, 3, 13, 52
"/nfs/homes/kkonarze/Portfolio/Core/Project05/webserv/default.conf", "Properties", 0, 0, 0, 0, 28, 7, 7, 42
"/nfs/homes/kkonarze/Portfolio/Core/Project05/webserv/errors/404.html", "HTML", 0, 0, 0, 38, 0, 0, 0, 38
"/nfs/homes/kkonarze/Portfolio/Core/Project05/webserv/include/Client.hpp", "C++", 26, 0, 0, 0, 0, 11, 9, 46
"/nfs/homes/kkonarze/Portfolio/Core/Project05/webserv/include/Config.hpp", "C++", 17, 0, 0, 0, 0, 11, 6, 34
"/nfs/homes/kkonarze/Portfolio/Core/Project05/webserv/include/ConfigParser.hpp", "C++", 35, 0, 0, 0, 0, 11, 11, 57
"/nfs/homes/kkonarze/Portfolio/Core/Project05/webserv/include/EpollState.hpp", "C++", 12, 0, 0, 0, 0, 11, 4, 27
"/nfs/homes/kkonarze/Portfolio/Core/Project05/webserv/include/Location.hpp", "C++", 21, 0, 0, 0, 0, 11, 8, 40
"/nfs/homes/kkonarze/Portfolio/Core/Project05/webserv/include/Request.hpp", "C++", 23, 0, 0, 0, 0, 11, 8, 42
"/nfs/homes/kkonarze/Portfolio/Core/Project05/webserv/include/Response.hpp", "C++", 22, 0, 0, 0, 0, 11, 9, 42
"/nfs/homes/kkonarze/Portfolio/Core/Project05/webserv/include/Server.hpp", "C++", 29, 0, 0, 0, 0, 11, 10, 50
"/nfs/homes/kkonarze/Portfolio/Core/Project05/webserv/include/ServerManager.hpp", "C++", 23, 0, 0, 0, 0, 11, 11, 45
"/nfs/homes/kkonarze/Portfolio/Core/Project05/webserv/include/Signal.hpp", "C++", 13, 0, 0, 0, 0, 11, 7, 31
"/nfs/homes/kkonarze/Portfolio/Core/Project05/webserv/include/Webserv.hpp", "C++", 30, 0, 0, 0, 0, 12, 4, 46
"/nfs/homes/kkonarze/Portfolio/Core/Project05/webserv/src/ConfigTokens.cpp", "C++", 103, 0, 0, 0, 0, 11, 29, 143
"/nfs/homes/kkonarze/Portfolio/Core/Project05/webserv/src/Definitions/Client.cpp", "C++", 60, 0, 0, 0, 0, 11, 12, 83
"/nfs/homes/kkonarze/Portfolio/Core/Project05/webserv/src/Definitions/ConfigParser.cpp", "C++", 123, 0, 0, 0, 0, 37, 26, 186
"/nfs/homes/kkonarze/Portfolio/Core/Project05/webserv/src/Definitions/Location.cpp", "C++", 48, 0, 0, 0, 0, 30, 18, 96
"/nfs/homes/kkonarze/Portfolio/Core/Project05/webserv/src/Definitions/Request.cpp", "C++", 91, 0, 0, 0, 0, 11, 18, 120
"/nfs/homes/kkonarze/Portfolio/Core/Project05/webserv/src/Definitions/Response.cpp", "C++", 105, 0, 0, 0, 0, 18, 23, 146
"/nfs/homes/kkonarze/Portfolio/Core/Project05/webserv/src/Definitions/Server.cpp", "C++", 66, 0, 0, 0, 0, 11, 17, 94
"/nfs/homes/kkonarze/Portfolio/Core/Project05/webserv/src/Definitions/ServerManager.cpp", "C++", 112, 0, 0, 0, 0, 11, 18, 141
"/nfs/homes/kkonarze/Portfolio/Core/Project05/webserv/src/Definitions/Signal.cpp", "C++", 17, 0, 0, 0, 0, 11, 8, 36
"/nfs/homes/kkonarze/Portfolio/Core/Project05/webserv/src/Utils.cpp", "C++", 70, 0, 0, 0, 0, 62, 14, 146
"/nfs/homes/kkonarze/Portfolio/Core/Project05/webserv/src/main.cpp", "C++", 35, 0, 0, 0, 0, 11, 10, 56
"/nfs/homes/kkonarze/Portfolio/Core/Project05/webserv/www/index.html", "HTML", 0, 0, 0, 21, 0, 0, 6, 27
"/nfs/homes/kkonarze/Portfolio/Core/Project05/webserv/www/style.css", "PostCSS", 0, 0, 36, 0, 0, 0, 0, 36
"/nfs/homes/kkonarze/Portfolio/Core/Project05/webserv/www/thankyou.html", "HTML", 0, 0, 0, 28, 0, 0, 3, 31
"Total", "-", 1081, 36, 36, 87, 28, 356, 309, 1933